900;580;40;200;0;300;1200;577;40;200;0;300;1051;447;340;40;0;400;901;318;40;200;0;150;1201;318;40;200;0;150;1051;188;340;40;0;220;500;612;40;130;0;30;800;612;40;130;0;30;650;518;340;40;0;50;500;453;40;70;0;5;800;453;40;70;0;5;650;388;340;40;0;10;
900;577;40;200;0;300;1200;577;40;200;0;300;1051;448;340;40;0;400;901;318;40;200;0;150;1201;318;40;200;0;150;1051;188;340;40;0;220;
900;577;40;200;0;300;1200;577;40;200;0;300;1051;447;340;40;0;400;901;318;40;200;0;150;1200;318;40;200;0;150;1049;188;340;40;0;220;500;612;40;130;0;30;800;612;40;130;0;30;650;517;340;40;0;50;502;453;40;70;0;5;811;453;40;70;0;5;649;55;340;40;0;10;
900;577;40;200;0;300;1200;577;40;200;0;300;1053;447;340;40;0;400;569;577;40;200;0;150;781;577;40;200;0;150;681;448;340;40;0;220;580;353;40;130;0;30;799;353;40;130;0;30;689;258;340;40;0;50;786;193;40;70;0;5;581;193;40;70;0;5;675;128;340;40;0;10;
900;577;40;200;0;300;1200;577;40;200;0;300;1053;447;340;40;0;400;569;577;40;200;0;150;781;577;40;200;0;150;681;448;340;40;0;220;580;353;40;130;0;30;792;353;40;130;0;30;689;258;340;40;0;50;1540;657;40;70;0;5;581;193;40;70;0;5;1055;156;340;40;0;10;1044;398;340;40;0;10;1037;350;340;40;0;10;1042;302;340;40;0;10;1042;254;340;40;0;10;1044;205;340;40;0;10;
899;575;40;200;0;300;1200;575;40;200;0;300;1052;445;340;40;0;400;897;315;40;200;0;150;1197;315;40;200;0;150;1046;185;340;40;0;220;500;420;40;130;0;30;790;420;40;130;0;30;646;515;340;40;0;50;633;325;340;40;0;50;547;610;40;130;0;50;810;610;40;130;0;50;
900;577;40;200;0;300;1200;577;40;200;0;300;1051;447;340;40;0;400;901;318;40;200;0;150;1200;318;40;200;0;150;1050;188;340;40;0;220;500;612;40;130;0;30;800;612;40;130;0;30;650;518;340;40;0;50;500;453;40;70;0;5;800;453;40;70;0;5;650;388;340;40;0;10;
900;577;40;200;0;300;1200;577;40;200;0;300;1053;448;340;40;0;400;569;577;40;200;0;150;781;577;40;200;0;150;681;447;340;40;0;220;580;353;40;130;0;30;799;353;40;130;0;30;689;258;340;40;0;50;786;193;40;70;0;5;581;193;40;70;0;5;675;128;340;40;0;10;
